#domain
hospital
#levelname
MACoronAI
#colors
red: 0, 2, 4, A
blue: 1, 3, 5, B
#initial
++++++++++++++++++++++
+0A       ++       B2+
+         ++         +
+++++ ++++++++++ +++++
+         ++         +
+1B       ++       A3+
++++++++++++++++++++++
#goal
++++++++++++++++++++++
+B        ++        A+
+         ++         +
+++++ ++++++++++ +++++
+         ++         +
+A        ++        B+
++++++++++++++++++++++
#end
