#domain
hospital
#levelname
MAMAAIStro
#colors
blue: 0, A
red: 1, B
#initial
++++++++++++++++
+0          A  +
+++ ++++++ + + +
+++ + B 1+ + + +
+++ + ++++ + + +
+++ +      + + +
+++ ++++++++ + +
+++            +
++++++++++++++++
#goal
++++++++++++++++
+              +
+++ ++++++ + + +
+++ +    + + + +
+++ + ++++ + + +
+++ +      + + +
+++ ++++++++ + +
+++   A B      +
++++++++++++++++
#end
