#domain
hospital
#levelname
SAtest
#colors
red: 0, A
#initial
+++++++++++++++++++++++++++
+                     A 0 +
+                         +
+++++++++++++++++++++++++++
#goal
+++++++++++++++++++++++++++
+                         +
+             A       0   +
+++++++++++++++++++++++++++
#end
