#domain
hospital
#levelname
SAtest
#colors
red: 0
blue: 1, B
#initial
+++++++++++++++++++++++++++
+ 1B                    0 +
+                         +
+++++++++++++++++++++++++++
#goal
+++++++++++++++++++++++++++
+   B                     +
+                     0   +
+++++++++++++++++++++++++++
#end
