#domain
hospital
#levelname
SAtest
#colors
red: 0, 1, A
#initial
+++++++++++++++++++++++++++
+ 1      0A A             +
+  A                      +
+++++++++++++++++++++++++++
#goal
+++++++++++++++++++++++++++
+    A                    +
+ 1  A     A              +
+++++++++++++++++++++++++++
#end
