#domain
hospital
#levelname
SAtest
#colors
red: 0, A, B, C, D
#initial
+++++++++++++++++++++++++++
+ A B C D               + +
++++++++++++++++++++ ++++ +
+0                        +
+++++++++++++++++++++++++++
#goal
+++++++++++++++++++++++++++
+                       + +
++++++++++++++++++++ ++++ +
+AB                 C  D  +
+++++++++++++++++++++++++++
#end
