#domain
hospital
#levelname
SAtest
#colors
red: 0, A
blue: 1, B
#initial
+++++++++++++++++++++++++++
+ 1                  A  0 +
+  A                      +
+++++++++++++++++++++++++++
#goal
+++++++++++++++++++++++++++
+   A                     +
+          A              +
+++++++++++++++++++++++++++
#end
